{
	"tileset" : "tileset.png",
	"terrain" : [
		[8, 1, 1, 2, 1, 2, 9, 10, 11,  1,  9,  2,  11,  1,  2],
		[16, 2, 1, 1, 2, 2, 9, 11, 1,  14,  15,  2,  3,  5,  4],
		[12, 2, 11, 1, 1, 1, 9, 24, 21,  1,  1,  2,  39,  1,  68],
		[1, 2, 68, 262, 1, 12, 39, 10, 11,  2, 44, 263,  2,  19,  1],
		[1, 280, 2, 270, 2, 4, 9, 1, 3,  21,  1,  271,  1,  134,  2],
		[1, 1, 1, 278, 1, 241, 242, 242, 242, 243,  2,  279,  1,  23,  1],
		[1, 1, 1, 1, 2, 249, 250, 250,  250,  251,  1,  5,  4,  6,  7],
		[1, 2, 1, 2, 9, 249, 250, 250, 250, 251, 10, 11, 1, 1, 272],
		[1, 1, 126, 1, 1, 249, 250, 250, 250, 251, 1, 1, 5, 24, 24],
		[1, 1, 2, 261, 11, 257, 258, 258, 258, 259,  2,  262,  1,  1,  2],
		[1, 1, 1, 270, 1, 1, 1, 1, 1, 1, 1,  270,  2,  2,  241],
		[18, 19, 21, 278, 2, 1, 9, 10, 24,  1,  2,  278,  1,  1,  232],
		[18, 18, 18, 19, 1, 2, 10, 12, 11,  5,  2,  1,  217,  218,  219],
		[26, 26, 26, 29, 19, 21, 1, 1, 12,  1,  1,  2,  225,  226,  227],
		[26, 26, 26, 26, 27, 1, 1, 2, 1,  11,  1,  2,  233,  234,  235]
	]
}
