{
	"tileset" : "tileset.png",
	"terrain" : [
		[8, 2, 2, 2, 2, 2, 9, 10, 11,  2,  2,  2,  2,  2,  2],
		[16, 2, 2, 2, 2, 2, 9, 10, 11,  2,  2,  2,  2,  2,  2],
		[1, 2, 2, 2, 2, 2, 9, 10, 11,  2,  2,  2,  2,  2,  2],
		[1, 2, 2, 2, 2, 2, 9, 10, 11,  2,  2,  2,  2,  2,  2],
		[1, 2, 2, 2, 2, 2, 9, 10, 11,  2,  2,  2,  2,  2,  2],
		[1, 2, 2, 2, 2, 2, 9, 10, 11,  2,  2,  2,  2,  2,  2],
		[1, 2, 2, 2, 2, 2, 9, 10,  8,  6,  6,  6,  6,  6,  6],
		[1, 2, 2, 2, 2, 2, 9, 10, 10, 10, 10, 10, 10, 10, 10],
		[1, 2, 2, 2, 2, 2, 9, 10, 12, 14, 14, 14, 14, 14, 14],
		[1, 2, 2, 2, 2, 2, 9, 10, 11,  2,  2,  2,  2,  2,  2],
		[1, 2, 2, 2, 2, 2, 9, 10, 11,  2,  2,  2,  2,  2,  2],
		[1, 2, 2, 2, 2, 2, 9, 10, 11,  2,  2,  2,  2,  2,  2],
		[1, 2, 2, 2, 2, 2, 9, 10, 11,  2,  2,  2,  2,  2,  2],
		[1, 2, 2, 2, 2, 2, 9, 10, 11,  2,  2,  2,  2,  2,  2],
		[1, 2, 2, 2, 2, 2, 9, 10, 11,  2,  2,  2,  2,  2,  2]
	]
}
